
	1111111111111111
	1PCE000000000001
	1000111111100001
	1000100000100001
	1001100011110001
	1011101000010001
	1011100111110001
	1011100000100001
	1001100000100001
	1000101000100001
	1000101110100001
	1000111010100001
	1000000000000001
	1111111111111111