
	1111111111111111
	1PC0000000000C01
	1000111111100001
	10001E0000100001
	1001100011110001
	1011101000C10001
	1011100111110001
	1011100000100001
	100110000010C001
	1000101000100001
	1000101110100001
	1000111010100001
	1000000000000001
	1111111111111111