111111111111111111111111111111111111
1000P00010000000C0100C10000000000001
1000000010000000001000100000000E0001
100011111000001000100010000000000001
100000001000011100100000000000000001
100000001000111110111111111111011101
111110000001111110000000000100000001
100000011111111110000000000100000001
100000000000010000001100000100000001
111111111011110000001100000100000001
111111111011110000000000000100C00001
1CCCCCCCCCCC010000000000000100000001
1CCCCCCCCCCC000000000000000000000001
111111111111111111111111111111111111