11111111111111111111111111111111111111111111111111111111111111111111111111111111111111111111111111111111111111111
10P0000000000000000000000000000C00000000000000000000000000000000C000000000000000000000000000000000000000000000E01
10000000000000000000000000000000000000000000000000000000000000000000000000000000000000000000000000000000000000001
11111111111111111111111111111111111111111111111111111111111111111111111111111111111111111111111111111111111111111