111111111111111111111111111111111111
1000P0000000000000000000000000000001
100000000000000000000000000000E00001
111111111111111111111111111111111111